##########################################################################################
#                                      #                                                 #
#                                      #                                                 #
#                                      #                                                 #
#                                      #                                                 #
#                                      #                                                 #
#                                      #                                                 #
#                                      #                                                 #
#                                      #                                                 #
#                                      #                                                 #
#                                      #                                                 #
#                                      #                                                 #
#                                      #                                                 #
#                                      #                                                 #
#                                      #                                                 #
#                                      #                                                 #
##########################################################################################
#                                      #                                                 #
#                                      #                                                 #
#                                      #                                                 #
#                                      #                                                 #
#                                      #                                                 #
#                                      #                                                 #
#                                      #                                                 #
#                                      #                                                 #
#                                      #                                                 #
#                                      #                                                 #
##########################################################################################
#                                                                                        #
#                                                                                        #
#                                                                                        #
#                                                                                        #
#                                                                                        #
#                                                                                        #
#                                                                                        #
#                                                                                        #
#                                                                                        #
#                                                                                        #
#                                                                                        #
#                                                                                        #
#                                                                                        #
#                                                                                        #
#                                                                                        #
#                                                                                        #
#                                                                                        #
#                                                                                        #
#                                                                                        #
#                                                                                        #
#                                                                                        #
##########################################################################################
